NO ./assets/tile3.xpm
SO ./assets/wood2.xpm
WE ./assets/wood1.xpm
EA ./assets/bricks3.xpm

F 139,69,255
C 0,128,128

                        111111111111111111111111111111111111111111
111111111111111111111111000000000000000000000000000000000000000000111111111
100000100000000000000000000000000000000000000000000000000111111111111100001
10000010000000000000000000000000000000000000000000000000000000011111000001111111
100000100000000000000000000000000000000000000000000000000011110000000011111
100000100000000000000000000000000000000000000000000000000011110000000011111
10E000000000000000000000000000000000000000000000000000000011110000000011111
100000100000000000000000000000000000000000000000000000000011111110001111111
100000100000000000000000000000000000000000000000000011111111111111111111111
1000001000000000000000000001000011111111111111111111
 11111 11111111111111111111 1111