NO ./assets/tile3.xpm
SO ./assets/tile2.xpm
WE ./assets/wood5.xpm
EA ./assets/bricks2.xpm

F 85,59,19
C 0,244,128

111111111111111111111111111111111
100000100000000000000000000000001
10000010000000000000000000000N001
100000100000000000000000000000001
111110100000000000000000000000001
100000000000000000000011111111101
100000100000000000000010000000001
111111111111111111111111111111111