NO ./assets/tile1.xpm
SO ./assets/tile2.xpm
WE ./assets/wood1.xpm
EA ./assets/bricks4.xpm

F 139,69,19
C 0,128,128

111111111111111111111111111111111
100000100000000000000000000000001
100000100000000000000000000000001
100000100000000000000000000000001
100000100000000000000000000000001
10E000000000000000000000000000000
100000100000000000000000000000000
100000100000000000000000000111111
100000100000000000000000000100001
100000100000000000000000000000001
111111111111111111111111111111111